1111111111111
10P0C000C0001
1000010M01111
10C0010C01E11
1000C10000C01
1111111111111