1111111111111
10P0C000C0001
100J010M01111
10C0010C00E11
1111111111111